Vampire Weekend - Modern Vampires of the City
Daft Punk - Random Access Memories
Kurt Vile - Wakin on a Pretty Daze
Kanye West - Yeezus
Arcade Fire - Reflektor
Jon Hopkins - Immunity
Waxahatchee - Cerulean Salt
Disclosure - Settle
Death Grips - Government Plates
CHVRCHES - The Bones of What You Believe
Mikal Cronin - MCII
La Femme - Psycho Tropical Berlin
Unknown Mortal Orchestra - II
Julia Holter - Loud City Song
Machinedrum - Vapor City
Grouper - The Man Who Died in His Boat
Four Tet - Beautiful Rewind
Lady Lamb The Beekeeper - Ripely Pine
My Bloody Valentine - mbv
Boards of Canada - Tomorrow's Harvest
Oneohtrix Point Never - R Plus Seven
James Holden - The Inheritors
Dawn of Midi - Dysnomia
Foxygen - We Are The 21st Century Ambassadors of Peace and Magic
HAIM - Days Are Gone
Blondes - Swisher
Janelle Monae - The Electric Lady
Hiatus Kaiyote - Tawk Tomahawk
The Oh Sees - Floating Coffin
Wavves  - Afraid of Heights
Earl Sweatshirt - Doris
Forest Swords - Engravings
Darkside - Psychic
Thundercat - Apocalypse
Thao and the Get Down Stay Down - We The Common
Joanna Gruesome - Weird Sister
Rhye - Woman
Poli√ßa - Shulamith
Eric Copeland - Joke in the Hole
Iceage - You're Nothing
Fuzz - Fuzz
Moderat - II
Laurel Halo - Chance of Rain
The Range - Nonfiction
James Blake - Overgrown
Hebronix - Unreal
Ludovico Einaudi  - In a Time Lapse
Suuns - Images Du Futur
M.I.A. - Matangi
Deerhunter - Monomanaia
Milk Music - Cruise Your Illusiona
Atoms For Peace - AMOK
RJD2 - More Is than Isn't
Au Revoir Simone - Move in Spectrums
Speedy Ortiz - Major Arcana
The National - Trouble Will Find Me
London Grammar - If You Wait
Lloyd Miller and the Heliocentrics - Lloyd Miller and the Heliocentrics
Volcano Choir - Repave
John Wizards - John Wizards
King Krule - Six Feet Beneath the Moon
Drake - Nothing Was the Same
Jagwar Ma - Howlin
A$AP Rocky - Long.Live.A$AP
Kelela - CUT 4 ME
Laura Marling - Once I Was an Eagle
Ty Segall - Sleeper
Cave - Threace
Factory Floor - Factory Floor
The Blow - The Blow
Daughter - If You Leave
Justin Timberlake - The 20/20 Experience
Arctic Monkeys - AM
Run the Jewels - Run the Jewels
Glasser - Interiors
Buke and Gase - General Dome
Pity Sex - Feast of Love
MGMT - MGMT
Melt Yourself Down - Melt Yourself Down
Hooded Fang - Gravez
Tim Hecker - Virgins
Mount Kimbie - Cold Spring Fault Less Youth
Local Natives - Hummingbird
Juliana Barkwick - Nepenthe
Laura Mvula - Sing to the Moon
Endless Boogie - Long Island
Lorde - Pure Heroine
Phosphorescent - Muchacho
Charles Bradley - Victim of Love
Mazzy Star - Seasons of Your Day
Valerie June - Pushin Against a Stone
William Tyler - Impossible Truth
California X - California X
The Knife - Shaking the Habitual
Fuck Buttons - Slow Focus
Lapalux - Nostalchic
AlunaGeorge - Body Music
Baths - Obsidian
Zomby - With Love
Julia Kent - Character